111111111111
100000000001
10000E0C0001
1000000P0001
1000000P0001
111111111111
