111111111111
100E00001111
10000000CC01
111111000001
10E0000P0001
111111111111
