111111111111
10000P00C001
100000E00001
100000E00001
1000C0000P01
111111111111
