1111111111111
1000000P00001
1111111111111
