111111111111
1E0000000001
111111110P01
100000C10001
101111110001
100000000001
111111111111
