1111111111111111111111111
1C0000C001000000000000001
1000000001P01110000000001
1111110001000011111111101
1E00C000000000000001EC001
1111111111111111111111111
