1111111111111111111111111
100E000011000000000000001
10000000CC000000000000001
1111110000000000000111001
10E0000P00000000000110001
1111111111111111111111111
