1111111111111111111111111111
1E00000011000000001111100C01
10000000CC00000001000N000001
1111100000010011110000101001
1C00N00000001111000000011001
1111100000111100000000100001
11110001111000000000C0000001
1000000011000111110000011001
10000000C00011P0110C00N01001
111111000000N0001100N0101001
1C000000N00100111100001C1001
1111111111111111111111111111
