111111111111
100000000001
100000E00C01
111100000001
1000000N0P01
111111111111
