1111111111111111111111111111
1E00000011000000001111000C01
10000000CC00000011110N000001
1011100000000011110000101001
1C00N00000001111000000011001
1111100000111100000000100001
11110000111100000000C0000001
1000000011000111110000011001
10000000C00011P0110C00N01001
111110000000N0001100N0101001
1C000000N00000111100001C10E1
1111111111111111111111111111
