111111111111111111111111111111111111111
100E00001100000000111110000000000100001
10000000CC00000000000000111000000001001
111111000000000000111001111000000101001
10E0N00P0000000000011000110000000011001
111111110010001101111110000100000100001
111111110001111000111110011000000000001
100E00001100000000000000111100000011001
10000000CC00000000111110011000000100001
11111100000000N000011100111100000101001
10E000010000000000011000111100000101001
111111111111111111111111111111111111111
