111111111111111111111111111111111111111
100E00001100000000111110000000N00100001
10000000CC000000000000001110000N0001001
111111000000000000111001111000000101001
10E0N000000000000001100011000C0C0011001
11111111001000110111111000010C000100001
1111111100011110001111100110C00C0000001
100E00001100000000000000111100000011001
10000000CC0000000011111P0110C00C0100001
11111100000000N0000111001111000N0101001
10E000010000000000011000111100000101001
111111111111111111111111111111111111111
