111111111111
100000000001
111E10000C01
10111P000001
10C0000N0001
111111111111
