11111111111111111111111111111111111111111111111111
100E0000110000000000000011111110000000000000100001
10000000CC0000000000000011111110000000000000001001
11111100000000000001110011111110000000000000101001
10E0N00P000000000001100011111110000000000000001001
11111111001000110111111111110000100000000000100001
11111111000111100011111111100111000000000000001001
100E0000110000000000000000000010000111100000011001
10000000CC0000000000000011111110000011000000100001
11111100000000N00001110011111110000000000000101001
10E00001000000000001100011111110000000000000101001
11111111111111111111111111111111111111111111111111
