111111111111111111111111111111111111111
100C000011000000000000001110000000100C1
1000000N0100000000011100111011110010111
11111100000P00000001110011101C010010111
10C0000000N0000000011C001110110100N01C1
11111111001000110111111111100N010001001
111111110001111000111111111E00010000011
100C0000010000000E000000001111110000111
1111111111111111100000001111100N0000001
1C11111011111011100111100N0000000001011
10000000N00000000011C000111110000001C11
111111111111111111111111111111111111111
