111111111111
100000000001
1000000C0001
1111000E0001
1000000P0201
111111111111
